0000000000000000000000000
0000000000000000000000000
0000000000000000000000000
0000000000000000000000000
0000000000000000000000000
0000000000000000000000000
0000000000000000000000000
0000000000000001400000000
0000000000000001000000000
0000000000030011100000000
0000000000110010100000000
0000000001100300200000000
0000000001010111100000000
0000000002011101000000000
0000000001002003000000000
0000000001111011000000000
0000000001310000000000000
0000000000000000000000000
0000000000000000000000000
0000000000000000000000000
0000000000000000000000000
0000000000000000000000000
0000000000000000000000000
0000000000000000000000000
0000000000000000000000000
